type -
height -
width -
map
#############.....................................####################............
#############.....................................####################............
#############......................................##################.............
#############......................................##################.............
##############.....................................################...............
##############.....................................################...............
##############.......................................#############............##..
##############.......................................#############............##..
##############............................#...........#####..###.............#####
##############............................#...........#####..###.............#####
#############...........................######.............................#######
#############...........................######.............................#######
###########.............................########......................############
###########.............................########......................############
########.....#########.............###############....................############
########.....#########.............###############....................############
######.....#############...........###############....................############
######.....#############...........###############....................############
#####......###############................###.........................############
#####......###############................###.........................############
######.......#############............................####............############
######.......#############............................####............############
########........#####.#####.....................###########.............##########
##########..............###..........#.....##...#############...........##########
##########..............###..........#.....##...#############...........##########
###########..........................#########....###########.........############
###########..........................#########....###########.........############
#############......................###########.......######...........############
#############......................###########.......######...........############
##############.......................########...........................##########
##############.......................########...........................##########
################......................#####...............................###.####
################......................#####...............................###.####
##################....................#####.....................##............##..
##################....................#####.....................##............##..
########################..............####....................#####...............
########################..............####....................#####...............
########################.....................................########.............
########################.....................................########.............
##########################...................................######...............
